#######
##    #
##    #
##  $##
###$$+#
###  .#
#### .#
#######